1111111
   10001
111100001
11000011
 110N01111
11101111
1110111111
110001111
1111111
1111111111
