1111111
   10001
111100001
11000011
 1100011111
11101111
1110111111
110001111
111111111
1111111111
