111111111
100000001111
100000010001
100000011001
1000N0000001
110000000001
111111000111
111111111111
