R 600 600

NO includes/textures/redbrick.xpm

SO includes/textures/bluestone.xpm

WE includes/textures/greystone.xpm

EA includes/textures/purplestone.xpm

S includes/textures/barrel.xpm

F 220,100,0

C 221,10,0

111111111111111111111111
100000000000000000000001
100000000020000000000001
100E00000000000000000001
100000111110000101010001
100000100010000000000001
100000100010000100010001
100000100010000000000001
100000110110000101010001
100000000000000000000001
100000000000000000000001
100000000020000000000001
100000000000000000200001
100020000000000000000001
100000000000002000000001
100000000000000000000001
111111111000000000000001
110100001000000000000001
110000101002000000000001
110100001000000000000001
110111111000000000200001
110000000000000000000001
111111111000000000000001
111111111111111111111111
